You are yanked from your slumber with a howl, cold sweat streaming down your naked body. Disentangling yourself from your sheets, your head turns immediately towards the window, flinching away from the vision.

Experiment A
An Interactive Fiction by whiteline
Release 1 / Serial number 180503 / Inform 7 build 6M62 (I6/v6.33 lib 6/12N) SD

Bedroom
The baleful star stares in through your bedroom window. Your bed is a mess of tangled, sweaty sheets. The kitchen lies immediately to the east.

>look at the star
You dare not look upon it!

* * *

You are yanked from your slumber with a howl, cold sweat streaming down your naked body. Disentangling yourself from your sheets, your head turns immediately towards the window, flinching away from the vision.

Experiment A
An Interactive Fiction by whiteline
Release 1 / Serial number 180503 / Inform 7 build 6M62 (I6/v6.33 lib 6/12N) SD

Bedroom
The baleful star stares in through your bedroom window. Your bed is a mess of tangled, sweaty sheets. The kitchen lies immediately to the east.

>e
You crawl on all fours, slinking through the doorway away from the horrible light.

Kitchen
Pots and pans lie strewn across the floor.  Everything is upended. Your bedroom is to the west, your study lies to the south and the front door leads southwest.

Helicopter noises thunder overhead as searchlights glare in through the kitchen window.

>get pots
Your shaking hands lack the strength to lift them at the moment.

* * *

>e
You crawl on all fours, slinking through the doorway away from the horrible light.

Kitchen
Pots and pans lie strewn across the floor.  Everything is upended. Your bedroom is to the west, your study lies to the south and the front door leads southwest.

Helicopter noises thunder overhead as searchlights glare in through the kitchen window.

>w
Never!

Helicopter noises thunder overhead as searchlights glare in through the kitchen window.

>die
That's not a verb I recognise.

>the dead
That's not a verb I recognise.

>die
That's not a verb I recognise.

>die
That's not a verb I recognise.

>suicide
That's not a verb I recognise.

>eat
(the kitchenware)
That's plainly inedible.

>eat myself
You're plainly inedible.

>shine
(the kitchenware)
You rub the kitchenware.

>rub
(the kitchenware)
You rub the kitchenware.

>sedated
That's not a verb I recognise.

>:3
That's not a verb I recognise.

>:3c
That's not a verb I recognise.

>debug
That's not a verb I recognise.

>help
That's not a verb I recognise.

>cheat
That's not a verb I recognise.

* * *

>w
Never!

Helicopter noises thunder overhead as searchlights glare in through the kitchen window.

>sw
You are naked!

Helicopter noises thunder overhead as searchlights glare in through the kitchen window.

>s
Study
A desk is shoved up against a wall, covered in papers.

Your suit lies crumpled in a corner.

>get suit
You scurry into you rust-brown tweed suit like a frightened rat, quickly tying a Windsor knot from muscle memory.

>n
Kitchen
Pots and pans lie strewn across the floor.  Everything is in a mess. Your bedroom is to the west, your study lies to the south and the front door leads southwest.

You can see a front door here.

Helicopter noises thunder overhead as searchlights glare in through the kitchen window.

>sw
(first opening the front door)

Upper Corridor
Dark walls rising over wood flooring defines the corridor outside your apartment to the east.

You can see a front door here.

* * *

>e
You crawl on all fours, slinking through the doorway away from the horrible light.

Kitchen
Pots and pans lie strewn across the floor.  Everything is upended. Your bedroom is to the west, your study lies to the south and the front door leads southwest.

Helicopter noises thunder overhead as searchlights glare in through the kitchen window.

>look
Kitchen
Pots and pans lie strewn across the floor.  Everything is in a mess.

Helicopter noises thunder overhead as searchlights glare in through the kitchen window.

>w
Never!

Helicopter noises thunder overhead as searchlights glare in through the kitchen window.

* * *

>e
You crawl on all fours, slinking through the doorway away from the horrible light.

Kitchen
Pots and pans lie strewn across the floor.  Everything is upended. Your bedroom is to the west, your study lies to the south and the front door leads southwest.

Helicopter noises thunder overhead as searchlights glare in through the kitchen window.

>sw
You are naked!

Helicopter noises thunder overhead as searchlights glare in through the kitchen window.

* * *

>get suit
You scurry into you rust-brown tweed suit like a frightened rat, quickly tying a Windsor knot from muscle memory.

>n
Kitchen
Pots and pans lie strewn across the floor.  Everything is in a mess. Your bedroom is to the west, your study lies to the south and the front door leads southwest.

Helicopter noises thunder overhead as searchlights glare in through the kitchen window.

>sw
(first opening the front door)

Upper Corridor
Dark walls rising over wood flooring defines this corridor. There are doors east and west and a stairwell leads down to the ground floor.

Klezmer music streams out from one of the doors to the west.

* * *

>e
You crawl on all fours, slinking through the doorway away from the horrible light.

Kitchen
Pots and pans lie strewn across the floor.  Everything is upended. Your bedroom is to the west, your study lies to the south and the front door leads southwest.

Helicopter noises thunder overhead as searchlights glare in through the kitchen window.

>s
Study
A desk is shoved up against a wall, covered in papers.

Your suit lies crumpled in a corner.

>n
Kitchen
Pots and pans lie strewn across the floor.  Everything is in a mess. Your bedroom is to the west, your study lies to the south and the front door leads southwest.

Helicopter noises thunder overhead as searchlights glare in through the kitchen window.

>s
Study
A desk is shoved up against a wall, covered in papers.

>examine paper
You can't see any such thing.

>examine papers
It's your designs.

>examine desk
A simple desk. Papers cover the surface.

>get papers
That's hardly portable.

* * *

>get suit
You scurry into you rust-brown tweed suit like a frightened rat, quickly tying a Windsor knot from muscle memory.

>look
Study
A desk is shoved up against a wall, covered in papers.

>examine me
You are wearing your tweed suit. You brush off a few specks of dust from your arm.

>inv
You are carrying nothing.

* * *

>get suit
You scurry into you rust-brown tweed suit like a frightened rat, quickly tying a Windsor knot from muscle memory.

>n
Kitchen
Pots and pans lie strewn across the floor.  Everything is upended. Your bedroom is to the west, your study lies to the south and the front door leads southwest.

Helicopter noises thunder overhead as searchlights glare in through the kitchen window.

>sw
(first opening the front door)

Upper Corridor
Dark walls rising over wood flooring forms this corridor. There are doors east and west and a stairwell snakes down to the ground floor to the north.

Rhythmic violin music streams out from one of the doors to the west.

>listen music
I only understood you as far as wanting to listen.

>listen to the music
The shadows darken and lean in towards you.

>look
Ghetto
Large shadows move about all around you. Beyond them, enormous shapes covered in yellow lights reach up to an unseen sky.

>w
You attempt to push through the shadows on your sides but brusquely get jolted back. After a few attempts you manage to slip through.

Warsaw Grand Square
Here lies the great corpse-pit, a vast gulf of darkness fifty meters across encircled by the pavement of the Grand Square. Men in long black coats stand haggling in booths and by carts all around. The clock of the Palace reads midnight.

>look men
The black-robed men in hats are conducting commerce in a language you don't quite recognize but parts of it sounds German and west-Slavic.

A donkey cart full of naked, emaciated corpses arrive by the rim of the pit. As the cart tilts backward they fall first en masse, then one by one into the deep gulf.

The great bell of the Palace rings out into the night.

* * *

>listen music
I only understood you as far as wanting to listen.

>look music
The shadows darken and lean in towards you.

>look
Ghetto
Large shadows move about all around you. Beyond them, enormous shapes covered in yellow lights reach up to an unseen sky.

>n
You attempt to push through the shadows on your sides but brusquely get jolted back. After a few attempts you manage to slip through.

Warsaw Grand Square
Here lies the great corpse-pit, a vast gulf of darkness fifty meters across encircled by the pavement of the Grand Square. Men in long black coats stand haggling in booths and by carts all around. The clock of the Palace reads midnight.

>d
You take a few steps back and launch yourself into a running jump over the edge. You fall and fall and fall for what seems like several minutes.

A human skull catches your shoulder hard and the rest of your body slams into the top of a mountain of corpses. Down and down and down you tumble, coming to rest against the wall of the pit.

Charnel Pit
You are up against the edge of the pit, a barely curving wall of slimy gray brickwork. A morass of bones and rotting flesh crunch underfoot - enormous piles of corpses loom over you from all sides that is not the wall.

A wooden grate is affixed into the wall.

A donkey cart full of naked, emaciated corpses arrive by the rim of the pit. As the cart tilts backward they fall first en masse, then one by one into the deep gulf.

The great bell of the Palace rings out into the night.

>e
You can't go that way.

>look
Charnel Pit
You are up against the edge of the pit, a barely curving wall of slimy gray brickwork. A morass of bones and rotting flesh crunch underfoot - enormous piles of corpses loom over you from all sides that is not the wall.

A wooden grate is affixed into the wall.

>examine grate
A wooden grate, presumably to drain out rain-water.

* * *

>listen music
I only understood you as far as wanting to listen.

>n
Lobby
A front desk sits by the door leading out south-ways to the yard while a stairway to the north circles up into darkness. A wooden door stands in the north-eastern corner.

>d
You can't go that way.

>e
You have no business there.

>knock door
Which do you mean, the wooden door or the office door?

>office
You have no business there.

>n
Upper Corridor
Dark walls rising over wood flooring forms this corridor. There are doors east and west and a stairwell snakes down to the ground floor to the north.

Klezmer music streams out from one of the doors to the west.

>listen to the music
The shadows darken and lean in towards you.

* * *

>vomit
That's not a verb I recognise.

>smell
The part of your human nature that before now where in ignorance of your surroundings catch up to you and you retch as you empty your stomach upon the "ground".

>e
(first opening the wooden grate)
You desperately try to tear away one of the planks and the wet oak budges a little bit.

>e
(first opening the wooden grate)
You desperately try to tear away one of the planks and the wet oak budges a little bit.

>smell
You retch and heave but your stomach is empty.

>e
(first opening the wooden grate)
The rotting wood finally gives way, creating an opening for escape!

Symmetric Alley
A long alley, or road, flanked by perfectly symmetrical houses down to the seaside docks. Behind you is a gray brick wall.

A wooden grate is affixed into the wall.

A bright light descends between the houses with a great roar - you yell out in fear as you realize the gun-ship has you cornered!

Sharp pain shoots up from your left hand.

>look
Storage Closet
A naked light-bulb illuminates some shelving containing cleaning supplies and other, less identifiable things. The door to the west has been torn open, the wood in the frame splintered.

Sharp pain shoots up from your left hand.

>w
Lobby
A front desk sits by the door leading out south-ways to the yard while a stairway to the north circles up into darkness. A wooden door has been torn open in the north-eastern corner.

A puddle of vomit has spread on the floor.

Sharp pain shoots up from your left hand.

You hear sobbing from the door to the east, behind the counter.

>ne
Storage Closet
A naked light-bulb illuminates some shelving containing cleaning supplies and other, less identifiable things. The door to the west has been torn open, the wood in the frame splintered.

Sharp pain shoots up from your left hand.

>sw
You can't go that way.

Sharp pain shoots up from your left hand.

>e
You can't go that way.

Sharp pain shoots up from your left hand.

>w
Lobby
A front desk sits by the door leading out south-ways to the yard while a stairway to the north circles up into darkness. A wooden door has been torn open in the north-eastern corner.

A puddle of vomit has spread on the floor.

Sharp pain shoots up from your left hand.

You hear sobbing from the door to the east, behind the counter.

>e
You knock on the door. The sobbing temporarily turns into frightened yelps and screams.

Sharp pain shoots up from your left hand.

You hear sobbing from the door to the east, behind the counter.

>s
Front Yard
A small, paved yard with some bushes and trees, lying at an intersection of two streets to the south and east. Birds tweet in the sunlight.

Sharp pain shoots up from your left hand.

>n
Lobby
A front desk sits by the door leading out south-ways to the yard while a stairway to the north circles up into darkness. A wooden door has been torn open in the north-eastern corner.

A puddle of vomit has spread on the floor.

Sharp pain shoots up from your left hand.

You hear sobbing from the door to the east, behind the counter.

>u
Upper Corridor
Dark walls rising over wood flooring forms this corridor. There are doors east and west and a stairwell snakes down to the ground floor to the north.

Sharp pain shoots up from your left hand.

>e
Kitchen
Pots and pans lie strewn across the floor.  Everything is upended. Your bedroom is to the west, your study lies to the south and the front door leads southwest.

Sharp pain shoots up from your left hand.

>look window
A few cars stand parked on the street outside as people walk past.

Sharp pain shoots up from your left hand.

>restart
Are you sure you want to restart?

>yes
You are yanked from your slumber with a howl, cold sweat streaming down your body!

a
An Interactive Fiction by whiteline
Release 1 / Serial number 180303 / Inform 7 build 6M62 (I6/v6.33 lib 6/12N) SD

Bedroom
The baleful star shines in through the window. Your bed is a mess. The kitchen lies to the east.

>e
You crawl on all fours, slinking through the doorway away from the horrible light.

Kitchen
Pots and pans lie strewn across the floor.  Everything is upended. Your bedroom is to the west, your study lies to the south and the front door leads southwest.

Helicopter noises thunder overhead as searchlights glare in through the kitchen window.

>look window
In the street outside the death-squads are fighting back the rabble as the gun-ships fly overhead providing fire support. There seems to be many losses on both sides.

Helicopter noises thunder overhead as searchlights glare in through the kitchen window.

* * *

>sw
(first opening the front door)

Upper Corridor
Dark walls rising over wood flooring forms this corridor. There are doors east and west and a stairwell snakes down to the ground floor to the north.

Rhythmic violin music streams out from one of the doors to the west.

>get music
The shadows darken and lean in towards you.

>n
You attempt to push through the shadows on your sides but brusquely get jolted back. After a few attempts you manage to slip through.

Warsaw Grand Square
Here lies the great corpse-pit, a vast gulf of darkness fifty meters across encircled by the pavement of the Grand Square. Men in long black coats stand haggling in booths and by carts all around. The clock of the Palace reads midnight.

* * *

>smell corpses
The part of your human nature that before now where in ignorance of your surroundings catch up to you and you retch as you empty your stomach upon the "ground".

>smell corpses
You retch and heave but your stomach is empty.

>look
Charnel Pit
You are up against the edge of the pit, a barely curving wall of slimy gray brickwork. A morass of bones and rotting flesh crunch underfoot - enormous piles of corpses loom over you from all sides that is not the wall.

A wooden grate is affixed into the wall.

>e
(first opening the wooden grate)
You desperately try to tear away one of the planks and the wet oak budges a little bit.

>e
(first opening the wooden grate)
The rotting wood finally gives way, creating an opening for escape!

Symmetric Alley
A long alley, or road, flanked by perfectly symmetrical houses down to the seaside docks. Behind you is a gray brick wall.

A wooden grate is affixed into the wall.

A bright light descends between the houses with a great roar - you yell out in fear as you realize the gun-ship has you cornered!

Sharp pain shoots up from your left hand.

* * *

>look
Storage Closet
A naked light-bulb illuminates some shelving containing cleaning supplies and other, less identifiable things. The door to the west has been torn open, the wood in the frame splintered.

Sharp pain shoots up from your left hand.

>w
Lobby
A front desk sits by the door leading out south-ways to the yard while a stairway to the north circles up into darkness. A wooden door has been torn open in the north-eastern corner.

A puddle of vomit has spread on the floor.

Sharp pain shoots up from your left hand.

* * *

>sw
(first opening the front door)

Upper Corridor
Dark walls rising over wood flooring forms this corridor. There are doors east and west and a stairwell snakes down to the ground floor to the north.

Rhythmic violin music streams out from one of the doors to the west.

>d
Lobby
A front desk sits by the door leading out south-ways to the yard while a stairway to the north circles up into darkness. A wooden door stands in the north-eastern corner.

>n
You can't go that way.

* * *

>d
Lobby
A front desk sits by the door leading out south-ways to the yard while a stairway to the north circles up into darkness. A wooden door stands in the north-eastern corner.

>e
You can't go that way.

>be
That's not a verb I recognise.

>ne
(first opening the wooden door)
It seems to be locked.

>s
Upper Corridor
Dark walls rising over wood flooring forms this corridor. There are doors east and west and a stairwell snakes down to the ground floor to the north.

Klezmer music streams out from one of the doors to the west.

>n
Lobby
A front desk sits by the door leading out south-ways to the yard while a stairway to the north circles up into darkness. A wooden door stands in the north-eastern corner.

>n
Upper Corridor
Dark walls rising over wood flooring forms this corridor. There are doors east and west and a stairwell snakes down to the ground floor to the north.

Klezmer music streams out from one of the doors to the west.

>take music
The shadows darken and lean in towards you.

>n
You attempt to push through the shadows on your sides but brusquely get jolted back. After a few attempts you manage to slip through.

Warsaw Grand Square
Here lies the great corpse-pit, a vast gulf of darkness fifty meters across encircled by the pavement of the Grand Square. Men in long black coats stand haggling in booths and by carts all around. The clock of the Palace reads midnight.

>look palace
The great stained-glass windows of the Palace of Trade glimmers in the electric-lights that also illuminates its great clock.

A donkey cart full of naked, emaciated corpses arrive by the rim of the pit. As the cart tilts backward they fall first en masse, then one by one into the deep gulf.

The great bell of the Palace rings out into the night.

>d
You take a few steps back and launch yourself into a running jump over the edge. You fall and fall and fall for what seems like several minutes.

A human skull catches your shoulder hard and the rest of your body slams into the top of a mountain of corpses. Down and down and down you tumble, coming to rest against the wall of the pit.

Charnel Pit
You are up against the edge of the pit, a barely curving wall of slimy gray brickwork. A morass of bones and rotting flesh crunch underfoot - enormous piles of corpses loom over you from all sides that is not the wall.

A wooden grate is affixed into the wall.

>w
You can't go that way.

>u
Warsaw Grand Square
Here lies the great corpse-pit, a vast gulf of darkness fifty meters across encircled by the pavement of the Grand Square. Men in long black coats stand haggling in booths and by carts all around. The clock of the Palace reads midnight.

>d
You take a few steps back and launch yourself into a running jump over the edge. You fall and fall and fall for what seems like several minutes.

A human skull catches your shoulder hard and the rest of your body slams into the top of a mountain of corpses. Down and down and down you tumble, coming to rest against the wall of the pit.

Charnel Pit
You are up against the edge of the pit, a barely curving wall of slimy gray brickwork. A morass of bones and rotting flesh crunch underfoot - enormous piles of corpses loom over you from all sides that is not the wall.

A wooden grate is affixed into the wall.

* * *

>d
Lobby
A front desk sits by the door leading out south-ways to the yard while a stairway to the north circles up into darkness. A wooden door stands in the north-eastern corner.

>u
Upper Corridor
Dark walls rising over wood flooring forms this corridor. There are doors east and west and a stairwell snakes down to the ground floor to the north.

Klezmer music streams out from one of the doors to the west.

>listen to the music
The shadows darken and lean in towards you.

>n
You attempt to push through the shadows on your sides but brusquely get jolted back. After a few attempts you manage to slip through.

Warsaw Grand Square
Here lies the great corpse-pit, a vast gulf of darkness fifty meters across encircled by the pavement of the Grand Square. Men in long black coats stand haggling in booths and by carts all around. The clock of the Palace reads midnight.

* * *

>smell corpses
The part of your human nature that before now where in ignorance of your surroundings catch up to you and you retch as you empty your stomach upon the "ground".

>e
(first opening the wooden grate)
You desperately try to tear away one of the planks and the wet oak budges a little bit.

* * *

>e
(first opening the wooden grate)
The rotting wood finally gives way, creating an opening for escape!

Symmetric Alley
A long alley, or road, flanked by perfectly symmetrical houses down to the seaside docks. Behind you is a gray brick wall.

A wooden grate is affixed into the wall.

A bright light descends between the houses with a great roar - you yell out in fear as you realize the gun-ship has you cornered!

Sharp pain shoots up from your left hand.

>w
Lobby
A front desk sits by the door leading out south-ways to the yard while a stairway to the north circles up into darkness. A wooden door has been torn open in the north-eastern corner.

A puddle of vomit has spread on the floor.

Sharp pain shoots up from your left hand.

You hear sobbing from the door to the east, behind the counter.

* * *

>sw
(first opening the front door)

Upper Corridor
Dark walls rising over wood flooring forms this corridor. There are doors east and west and a stairwell snakes down to the ground floor to the north.

Rhythmic violin music streams out from one of the doors to the west.

>n
You walk down the stairs and enter the lobby.

Lobby
A front desk sits by the door leading out south-ways to the yard while a stairway to the north circles up into darkness. A wooden door stands in the north-eastern corner.

>ne
(first opening the wooden door)
It seems to be locked.

>open door
It seems to be locked.

* * *

>n
You walk down the stairs and enter the lobby.

Lobby
A front desk sits by the door leading out south-ways to the yard while a stairway to the north circles up into darkness. A wooden door stands in the north-eastern corner.

>s
Upper Corridor
Dark walls rising over wood flooring forms this corridor. There are doors east and west and a stairwell snakes down to the ground floor to the north.

Klezmer music streams out from one of the doors to the west.

>listen to the music
The shadows darken and lean in towards you.

* * *

>n
You attempt to push through the shadows on your sides but brusquely get jolted back. After a few attempts you manage to slip through.

Warsaw Grand Square
Here lies the great corpse-pit, a vast gulf of darkness fifty meters across encircled by the pavement of the Grand Square. Men in long black coats stand haggling in booths and by carts all around. The clock of the Palace reads midnight.

>wait
Time passes.

A donkey cart full of naked, emaciated corpses arrive by the rim of the pit. As the cart tilts backward they fall first en masse, then one by one into the deep gulf.

The great bell of the Palace rings out into the night.

>look palace
The great stained-glass windows of the Palace of Trade glimmers in the electric-lights that also illuminates its great clock.

>look pit
You can't see any such thing.

>look man
You can't see any such thing.

>look men
The black-robed men in hats are conducting commerce in a language you don't quite recognize but parts of it sounds German and west-Slavic.

>d
You take a few steps back and launch yourself into a running jump over the edge. You fall and fall and fall for what seems like several minutes.

A human skull catches your shoulder hard and the rest of your body slams into the top of a mountain of corpses. Down and down and down you tumble, coming to rest against the wall of the pit.

Charnel Pit
You are up against the edge of the pit, a barely curving wall of slimy gray brickwork. A morass of bones and rotting flesh crunch underfoot - enormous piles of corpses loom over you from all sides that is not the wall.

A wooden grate, presumably to drain out rain-water.

* * *

>n
You walk down the stairs and enter the lobby.

Lobby
A front desk sits by the door leading out south-ways to the yard while a stairway to the north circles up into darkness. A wooden door stands in the north-eastern corner.

>d
You can't go that way.

>s
Front Yard
A small, paved yard with some bushes and trees, lying at an intersection of two streets to the south and east. Birds tweet in the sunlight.

>n
Lobby
A front desk sits by the door leading out south-ways to the yard while a stairway to the north circles up into darkness. A wooden door stands in the north-eastern corner.

>s
Front Yard
A small, paved yard with some bushes and trees, lying at an intersection of two streets to the south and east. Birds tweet in the sunlight.

* * *

>n
Lobby
A front desk sits by the door leading out south-ways to the yard while a stairway to the north circles up into darkness. A wooden door stands in the north-eastern corner.

>u
Upper Corridor
Dark walls rising over wood flooring forms this corridor. There are doors east and west and a stairwell snakes down to the ground floor to the north.

Klezmer music streams out from one of the doors to the west.

>e
Kitchen
Pots and pans lie strewn across the floor.  Everything is upended. Your bedroom is to the west, your study lies to the south and the front door leads southwest.

>examine window
In the street outside the death-squads are fighting back the rabble as the gun-ships fly overhead providing fire support. There seems to be many losses on both sides.

* * *

>d
You can't go that way.

>u
Upper Corridor
Dark walls rising over wood flooring forms this corridor. There are doors east and west and a stairwell snakes down to the ground floor to the north.

Klezmer music streams out from one of the doors to the west.

* * *

>smell corpses
The part of your human nature that before now where in ignorance of your surroundings catch up to you and you retch as you empty your stomach upon the "ground".

>smell
The part of your human nature that before now where in ignorance of your surroundings catch up to you and you retch as you empty your stomach upon the "ground".

* * *

>n
You attempt to push through the shadows on your sides but brusquely get jolted back. After a few attempts you manage to slip through.

Warsaw Grand Square
Here lies the great corpse-pit, a vast gulf of darkness fifty meters across encircled by the pavement of the Grand Square. Men in long black coats stand haggling in booths and by carts all around. The clock of the Palace reads midnight.

>examine men
The black-robed men in hats are conducting commerce in a language you don't quite recognize but parts of it sounds German and west-Slavic.

A donkey cart full of naked, emaciated corpses arrive by the rim of the pit. As the cart tilts backward they fall first en masse, then one by one into the deep gulf.

The great bell of the Palace rings out into the night.

>examine palace
The great stained-glass windows of the Palace of Trade glimmers in the electric-lights that also illuminates its great clock.

>d
You take a few steps back and launch yourself into a running jump over the edge. You fall and fall and fall for what seems like several minutes.

A human skull catches your shoulder hard and the rest of your body slams into the top of a mountain of corpses. Down and down and down you tumble, coming to rest against the wall of the pit.

Charnel Pit
You are up against the edge of the pit, a barely curving wall of slimy gray brickwork. A morass of bones and rotting flesh crunch underfoot - enormous piles of corpses loom over you from all sides that is not the wall.

A wooden grate is affixed into the wall.

>smell
The part of your human nature that before now where in ignorance of your surroundings catch up to you and you retch as you empty your stomach upon the "ground".

* * *

>e
(first opening the wooden grate)
The rotting wood finally gives way, creating an opening for escape!

Symmetric Alley
A long alley, or road, flanked by perfectly symmetrical houses down to the seaside docks. Behind you is a gray brick wall.

A wooden grate is affixed into the wall.

A bright light descends between the houses with a great roar - you yell out in fear as you realize the gun-ship has you cornered!

Sharp pain shoots up from your left hand.

>examine gun-ship
You can't see any such thing.

>look
Storage Closet
A naked light-bulb illuminates some shelving containing cleaning supplies and other, less identifiable things. The door to the west has been torn open, the wood in the frame splintered.

Sharp pain shoots up from your left hand.

>examine hand
You are wearing your tweed suit. You brush off a few specks of dust from your arm.
 Your left hand has several large splinters in it and is slick with blood.

Sharp pain shoots up from your left hand.

>w
Lobby
A front desk sits by the door leading out south-ways to the yard while a stairway to the north circles up into darkness. A wooden door has been torn open in the north-eastern corner.

A puddle of vomit has spread on the floor.

Sharp pain shoots up from your left hand.

You hear sobbing from the door to the east, behind the counter.

>examine door
Which do you mean, the wooden door or the office door?

>examine office
A door behind the desk, presumably leading to your landlords office. Loud sobbing can be heard from inside.

Sharp pain shoots up from your left hand.

You hear sobbing from the door to the east, behind the counter.

>u
Upper Corridor
Dark walls rising over wood flooring forms this corridor. There are doors east and west and a stairwell snakes down to the ground floor to the north.

Sharp pain shoots up from your left hand.

>d
Lobby
A front desk sits by the door leading out south-ways to the yard while a stairway to the north circles up into darkness. A wooden door has been torn open in the north-eastern corner.

A puddle of vomit has spread on the floor.

Sharp pain shoots up from your left hand.

You hear sobbing from the door to the east, behind the counter.

* * *

>n
You walk down the stairs and enter the lobby.

Lobby
A front desk sits by the door leading out south-ways to the yard while a stairway to the north circles up into darkness. A wooden door stands in the north-eastern corner.

>u
You walk up the stairs and wind up in the corridor.

Upper Corridor
Dark walls rising over wood flooring forms this corridor. There are doors east and west and a stairwell snakes down to the ground floor to the north.

Klezmer music streams out from one of the doors to the west.

>quit
Are you sure you want to quit?

>yes
[ The game has finished ]

* * *

>sw
(first opening the front door)

Upper Corridor
Dark walls rising over wood flooring forms this corridor. There are doors east and west and a stairwell snakes down to the ground floor to the north.

Rhythmic violin music streams out from one of the doors to the west.

>listen to music
The shadows darken and lean in towards you.

>look
Ghetto
Large shadows move about all around you. Beyond them, enormous shapes covered in yellow lights reach up to an unseen sky.

* * *

>n
You attempt to push through the shadows on your sides but brusquely get jolted back. After a few attempts you manage to slip through.

Warsaw Grand Square
Here lies the great corpse-pit, a vast gulf of darkness fifty meters across encircled by the pavement of the Grand Square. Men in long black coats stand haggling in booths and by carts all around. The clock of the Palace reads midnight.

>wait
Time passes.

A donkey cart full of emaciated, naked corpses arrive by the rim of the pit. As the cart tilts backward they fall first en masse, then one by one into the deep gulf.

The great bell of the Palace rings out into the night.

* * *

>listen to music
The shadows darken and lean in towards you.

>n
You attempt to push through the shadows on your sides but brusquely get jolted back. After a few attempts you manage to slip through.

Warsaw Grand Square
Here lies the great corpse-pit, a vast gulf of darkness fifty meters across encircled by the pavement of the Grand Square. Men in long black coats stand haggling in booths and by carts all around. The clock of the Palace reads midnight.

* * *

>look
Charnel Pit
You are up against the edge of the pit, a barely curving wall of slimy gray brickwork. A morass of bones and rotting flesh crunch underfoot - enormous piles of corpses loom over you from all sides that is not the wall.

A wooden grate is affixed into the wall.

>open grate
It seems to be locked.

>open grate
It seems to be locked.

>open grate
The rotting wood finally gives way, creating an opening for escape!

>look
Charnel Pit
You are up against the edge of the pit, a barely curving wall of slimy gray brickwork. A morass of bones and rotting flesh crunch underfoot - enormous piles of corpses loom over you from all sides that is not the wall.

A wooden grate is affixed into the wall.

>e
You can't go that way.

* * *

>sw
(first opening the front door)

Upper Corridor
Dark walls rising over wood flooring forms this corridor. There are doors east and west and a stairwell snakes down to the ground floor to the north.

Rhythmic violin music streams out from one of the doors to the west.

>listen to the music
The shadows darken and lean in towards you.

* * *

>n
You attempt to push through the shadows on your sides but brusquely get jolted back. After a few attempts you manage to slip through.

Warsaw Grand Square
Here lies the great corpse-pit, a vast gulf of darkness fifty meters across encircled by the pavement of the Grand Square. Men in long black coats stand haggling in booths and by carts all around. The clock of the Palace reads midnight.

>examine palace
The great stained-glass windows of the Palace of Trade glimmers in the electric-lights that also illuminates its great clock.

A donkey cart full of naked, emaciated corpses arrive by the rim of the pit. As the cart tilts backward they fall first en masse, then one by one into the deep gulf.

The great bell of the Palace rings out into the night.

>look west
You see nothing unexpected in that direction.

>d
You can't go that way.

* * *

>wait
Time passes.

A donkey cart full of naked, emaciated corpses arrive by the rim of the pit. As the cart tilts backward they fall first en masse, then one by one into the deep gulf.

The great bell of the Palace rings out into the night.

>d
You take a few steps back and launch yourself into a running jump over the edge. You fall and fall and fall for what seems like several minutes.

A human skull catches your shoulder hard and the rest of your body slams into the top of a mountain of corpses. Down and down and down you tumble, coming to rest against the wall of the pit.

Charnel Pit
You are up against the edge of the pit, a barely curving wall of slimy gray brickwork. A morass of bones and rotting flesh crunch underfoot - enormous piles of corpses loom over you from all sides that is not the wall.

A wooden grate is affixed into the wall.

>e
(first opening the wooden grate)
You desperately try to tear away one of the planks and the wet oak budges a little bit.

>e
(first opening the wooden grate)
The rotting wood finally gives way, creating an opening for escape!

Symmetric Alley
A long alley, or road, flanked by perfectly symmetrical houses down to the seaside docks.

A wooden grate is affixed into the wall.

* * *

>look
Ghetto
Large shadows move about all around you. Beyond them, enormous shapes covered in yellow lights reach up to an unseen sky.

>e
You attempt to push through the shadows on your sides but brusquely get jolted back. After a few attempts you manage to slip through.

Warsaw Grand Square
Here lies the great corpse-pit, a vast gulf of darkness fifty meters across encircled by the pavement of the Grand Square. Men in long black coats stand haggling in booths and by carts all around. The clock of the Palace reads midnight.

>d
You take a few steps back and launch yourself into a running jump over the edge. You fall and fall and fall for what seems like several minutes.

A human skull catches your shoulder hard and the rest of your body slams into the top of a mountain of corpses. Down and down and down you tumble, coming to rest against the wall of the pit.

Charnel Pit
You are up against the edge of the pit, a barely curving wall of slimy gray brickwork. A morass of bones and rotting flesh crunch underfoot - enormous piles of corpses loom over you from all sides that is not the wall.

A wooden grate is affixed into the wall.

A donkey cart full of naked, emaciated corpses arrive by the rim of the pit. As the cart tilts backward they fall first en masse, then one by one into the deep gulf.

The great bell of the Palace rings out into the night.

>open grate
You desperately try to tear away one of the planks and the wet oak budges a little bit.

>open grate
You desperately try to tear away one of the planks and the wet oak budges a little bit.

>open grate
The rotting wood finally gives way, creating an opening for escape!

>e
Symmetric Alley
A long alley, or road, flanked by perfectly symmetrical houses down to the seaside docks. Behind you is a gray brick wall.

A wooden grate is affixed into the wall.

A bright light descends between the houses with a great roar - you yell out in fear as you realize the gun-ship has you cornered!

>look
storage closet
A naked light-bulb illuminates some shelving containing cleaning supplies and other, less identifiable things. The door to the west has been torn open, the wood in the frame splintered.

>w
Lobby
A front desk sits by the door leading out south-ways to the yard while a stairway to the north circles up into darkness. A wooden door has been torn open in the north-eastern corner.

>u
Upper Corridor
Dark walls rising over wood flooring forms this corridor. There are doors east and west and a stairwell snakes down to the ground floor to the north.

Klezmer music streams out from one of the doors to the west.

>d
Lobby
A front desk sits by the door leading out south-ways to the yard while a stairway to the north circles up into darkness. A wooden door has been torn open in the north-eastern corner.

* * *

>e
(first opening the wooden grate)
You desperately try to tear away one of the planks and the wet oak budges a little bit.

>open grate
You desperately try to tear away one of the planks and the wet oak budges a little bit.

* * *

>open grate
The rotting wood finally gives way, creating an opening for escape!

>e
You can't go that way.

>w
symmetric houses
A long alley, or road, flanked by perfectly symmetrical houses down to the seaside docks.

A wooden grate is affixed into the wall.

* * *

>e
(first opening the wooden grate)
You desperately try to tear away one of the planks and the wet oak budges a little bit.

>taste
(the wooden grate)
The part of your human nature that before now where in ignorance of your surroundings catch up to you and you retch as you empty your stomach upon the "ground".

>look
Charnel Pit
You are up against the edge of the pit, a barely curving wall of slimy gray brickwork. A morass of bones and rotting flesh crunch underfoot - enormous piles of corpses loom over you from all sides that is not the wall.

A wooden grate is affixed into the wall.

* * *

>w
Lobby
A front desk sits by the door leading out south-ways to the yard while a stairway to the north circles up into darkness. A wooden door has been torn open in the north-eastern corner.

A puddle of vomit has spread on the floor.

Sharp pain shoots up from your left hand.

>examine puddle
Disgusting. There's a sour taste in your mouth.

Sharp pain shoots up from your left hand.

* * *

>n
You attempt to push through the shadows on your sides but brusquely get jolted back. After a few attempts you manage to slip through.

Warsaw Grand Square
Here lies the great corpse-pit, a vast gulf of darkness fifty meters across encircled by the pavement of the Grand Square. Men in long black coats stand haggling in booths and by carts all around. The clock of the Palace reads midnight.

>examine pit
The pit is encircled with the finest masonry this side of the Alps. It seems to eat all light that falls into it, so as to give an impression of a perfectly tranquil artificial lake in the night.

A donkey cart full of naked, emaciated corpses arrive by the rim of the pit. As the cart tilts backward they fall first en masse, then one by one into the deep gulf.

The great bell of the Palace rings out into the night.

>d
You take a few steps back and launch yourself into a running jump over the edge. You fall and fall and fall for what seems like several minutes.

A human skull catches your shoulder hard and the rest of your body slams into the top of a mountain of corpses. Down and down and down you tumble, coming to rest against the wall of the pit.

Charnel Pit
You are up against the edge of the pit, a barely curving wall of slimy gray brickwork. A morass of bones and rotting flesh crunch underfoot - enormous piles of corpses loom over you from all sides that is not the wall.

A wooden grate is affixed into the wall.

* * *

>sw
(first opening the front door)

Upper Corridor
Dark walls rising over wood flooring forms this corridor. There are doors east and west and a stairwell snakes down to the ground floor to the north.

Rhythmic violin music streams out from one of the doors to the west.

>use music
That's not a verb I recognise.

>look
Upper Corridor
Dark walls rising over wood flooring forms this corridor. There are doors east and west and a stairwell snakes down to the ground floor to the north.

Klezmer music streams out from one of the doors to the west.

>examine music
The shadows darken and lean in towards you.

>look
Ghetto
Large shadows move about all around you. Beyond them, enormous shapes covered in yellow lights reach up to an unseen sky.

* * *

>examine palace
The great stained-glass windows of the Palace of Trade glimmers in the electric-lights that also illuminates its great clock.

A donkey cart full of naked, emaciated corpses arrive by the rim of the pit. As the cart tilts backward they fall first en masse, then one by one into the deep gulf.

The great bell of the Palace rings out into the night.

>examine men
The black-robed men in hats are conducting commerce in a language you don't quite recognize but parts of it sounds German and west-Slavic.

>d
You take a few steps back and launch yourself into a running jump over the edge. You fall and fall and fall for what seems like several minutes.

A human skull catches your shoulder hard and the rest of your body slams into the top of a mountain of corpses. Down and down and down you tumble, coming to rest against the wall of the pit.

Charnel Pit
You are up against the edge of the pit, a barely curving wall of slimy gray brickwork. A morass of bones and rotting flesh crunch underfoot - enormous piles of corpses loom over you from all sides that is not the wall.

A wooden grate is affixed into the wall.

* * *

>look
Storage Closet
A naked light-bulb illuminates some shelving containing cleaning supplies and other, less identifiable things. The door to the west has been torn open, the wood in the frame splintered.

Sharp pain shoots up from your left hand.

>w
Lobby
A front desk sits by the door leading out south-ways to the yard while a stairway to the north circles up into darkness. A wooden door has been torn open in the north-eastern corner.

Sharp pain shoots up from your left hand.

>s
Front Yard
A small, paved yard with some bushes and trees, lying at an intersection of two streets to the south and east. Birds tweet in the sunlight.

Sharp pain shoots up from your left hand.

>n
Lobby
A front desk sits by the door leading out south-ways to the yard while a stairway to the north circles up into darkness. A wooden door has been torn open in the north-eastern corner.

Sharp pain shoots up from your left hand.

>u
Upper Corridor
Dark walls rising over wood flooring forms this corridor. There are doors east and west and a stairwell snakes down to the ground floor to the north.

Sharp pain shoots up from your left hand.

* * *

>e
Kitchen
Pots and pans lie strewn across the floor.  Everything is upended. Your bedroom is to the west, your study lies to the south and the front door leads southwest.

Sharp pain shoots up from your left hand.

>examine window
A few cars stand parked on the street outside as people walk past.

Sharp pain shoots up from your left hand.

>examine window
A few cars stand parked on the street outside as people walk past.

Sharp pain shoots up from your left hand.

>w
Never!

Sharp pain shoots up from your left hand.

>sw
Upper Corridor
Dark walls rising over wood flooring forms this corridor. There are doors east and west and a stairwell snakes down to the ground floor to the north.

Sharp pain shoots up from your left hand.

>d
Lobby
A front desk sits by the door leading out south-ways to the yard while a stairway to the north circles up into darkness. A wooden door has been torn open in the north-eastern corner.

Sharp pain shoots up from your left hand.

* * *

>sw
(first opening the front door)

Upper Corridor
Dark walls rising over wood flooring forms this corridor. There are doors east and west and a stairwell snakes down to the ground floor to the north.

Rhythmic violin music streams out from one of the doors to the west.

>enter music
The shadows darken and lean in towards you.

>n
You attempt to push through the shadows on your sides but brusquely get jolted back. After a few attempts you manage to slip through.

Warsaw Grand Square
Here lies the great corpse-pit, a vast gulf of darkness fifty meters across encircled by the pavement of the Grand Square. Men in long black coats stand haggling in booths and by carts all around. The clock of the Palace reads midnight.

* * *

>examine corpses
The part of your human nature that before now where in ignorance of your surroundings catch up to you and you retch as you empty your stomach upon the "ground".

>examine corpses
You retch and heave but your stomach is empty.

* * *

>sw
(first opening the front door)

Upper Corridor
Dark walls rising over wood flooring forms this corridor. There are doors east and west and a stairwell snakes down to the ground floor to the north.

Rhythmic violin music streams out from one of the doors to the west.

>examine music
The shadows darken and lean in towards you.

* * *

>examine palace
The great stained-glass windows of the Palace of Trade glimmers in the electric-lights that also illuminates its great clock.

A donkey cart full of naked, emaciated corpses arrive by the rim of the pit. As the cart tilts backward they fall first en masse, then one by one into the deep gulf.

The great bell of the Palace rings out into the night.

>examine pit
The pit is encircled with the finest masonry this side of the Alps. It seems to eat all light that falls into it, so as to give an impression of a perfectly tranquil artificial lake in the night.

* * *

>n
Kitchen
Pots and pans lie strewn across the floor.  Everything is upended. Your bedroom is to the west, your study lies to the south and the front door leads southwest.

Helicopter noises thunder overhead as searchlights glare in through the kitchen window.

>examine window
In the street outside the death-squads are fighting back the rabble as the gun-ships fly overhead providing fire support. There seems to be many losses on both sides.

Helicopter noises thunder overhead as searchlights glare in through the kitchen window.

>sw
(first opening the front door)

Upper Corridor
Dark walls rising over wood flooring forms this corridor. There are doors east and west and a stairwell snakes down to the ground floor to the north.

Klezmer music streams out from one of the doors to the west.

>examine music
The shadows darken and lean in towards you.

* * *

>examine palace
The great stained-glass windows of the Palace of Trade glimmers in the electric-lights that also illuminates its great clock.

A donkey cart full of naked, emaciated corpses arrive by the rim of the pit. As the cart tilts backward they fall first en masse, then one by one into the deep gulf.

The great bell of the Palace rings out into the night.

>d
You take a few steps back and launch yourself into a running jump over the edge. You fall and fall and fall for what seems like several minutes.

A human skull catches your shoulder hard and the rest of your body slams into the top of a mountain of corpses. Down and down and down you tumble, coming to rest against the wall of the pit.

Charnel Pit
You are up against the edge of the pit, a barely curving wall of slimy gray brickwork. A morass of bones and rotting flesh crunch underfoot - enormous piles of corpses loom over you from all sides that is not the wall.

A wooden grate is affixed into the wall.

* * *

>get suit
You scurry into you rust-brown tweed suit like a frightened rat, quickly tying a Windsor knot from muscle memory.

>examine desk
A simple desk. Papers cover the surface.

>examine papers
It's your designs.

>n
Kitchen
Pots and pans lie strewn across the floor.  Everything is upended. Your bedroom is to the west, your study lies to the south and the front door leads southwest.

Helicopter noises thunder overhead as searchlights glare in through the kitchen window.

* * *

>sw
(first opening the front door)

Upper Corridor
Dark walls rising over wood flooring forms this corridor. There are doors east and west and a stairwell snakes down to the ground floor to the north.

Klezmer music streams out from one of the doors to the west.

>listen to the music
The shadows darken and lean in towards you.

* * *

>examine men
The black-robed men in hats are conducting commerce in a language you don't quite recognize but parts of it sounds German and west-Slavic.

A donkey cart full of naked, emaciated corpses arrive by the rim of the pit. As the cart tilts backward they fall first en masse, then one by one into the deep gulf.

The great bell of the Palace rings out into the night.

>look men
The black-robed men in hats are conducting commerce in a language you don't quite recognize but parts of it sounds German and west-Slavic.

>d
You take a few steps back and launch yourself into a running jump over the edge. You fall and fall and fall for what seems like several minutes.

A human skull catches your shoulder hard and the rest of your body slams into the top of a mountain of corpses. Down and down and down you tumble, coming to rest against the wall of the pit.

Charnel Pit
You are up against the edge of the pit, a barely curving wall of slimy gray brickwork. A morass of bones and rotting flesh crunch underfoot - enormous piles of corpses loom over you from all sides that is not the wall.

A wooden grate is affixed into the wall.

* * *

>e
(first opening the wooden grate)
You desperately try to tear away one of the planks and the wet oak budges a little bit.

>u
The opening is just a small circle far, far above you.

>look up
You see nothing unexpected in that direction.

>e
(first opening the wooden grate)
You desperately try to tear away one of the planks and the wet oak budges a little bit.

>look east
You see nothing unexpected in that direction.

>e
(first opening the wooden grate)
The rotting wood finally gives way, creating an opening for escape!

Symmetric Alley
A long alley, or road, flanked by perfectly symmetrical houses down to the seaside docks. Behind you is a gray brick wall.

A wooden grate is affixed into the wall.

A bright light descends between the houses with a great roar - you yell out in fear as you realize the gun-ship has you cornered!

Sharp pain shoots up from your left hand.

>look gunship
You can't see any such thing.

>look
Storage Closet
A naked light-bulb illuminates some shelving containing cleaning supplies and other, less identifiable things. The door to the west has been torn open, the wood in the frame splintered.

Sharp pain shoots up from your left hand.

* * *

>s
Front Yard
A small, paved yard with some bushes and trees, lying at an intersection of two streets to the south and east. Birds tweet in the sunlight.

Sharp pain shoots up from your left hand.

>b
That's not a verb I recognise.

>b
That's not a verb I recognise.

>n
Lobby
A front desk sits by the door leading out south-ways to the yard while a stairway to the north circles up into darkness. A wooden door has been torn open in the north-eastern corner.

Sharp pain shoots up from your left hand.

>n
Upper Corridor
Dark walls rising over wood flooring forms this corridor. There are doors east and west and a stairwell snakes down to the ground floor to the north.

Klezmer music streams out from one of the doors to the west.

Sharp pain shoots up from your left hand.

>s
You can't go that way.

Sharp pain shoots up from your left hand.

>e
Kitchen
Pots and pans lie strewn across the floor.  Everything is upended. Your bedroom is to the west, your study lies to the south and the front door leads southwest.

Sharp pain shoots up from your left hand.

* * *

>look window
A few cars stand parked on the street outside as people walk past.

Sharp pain shoots up from your left hand.

>w
Never!

Sharp pain shoots up from your left hand.

>sw
Upper Corridor
Dark walls rising over wood flooring forms this corridor. There are doors east and west and a stairwell snakes down to the ground floor to the north.

Klezmer music streams out from one of the doors to the west.

Sharp pain shoots up from your left hand.

>d
Lobby
A front desk sits by the door leading out south-ways to the yard while a stairway to the north circles up into darkness. A wooden door has been torn open in the north-eastern corner.

Sharp pain shoots up from your left hand.

>s
Front Yard
A small, paved yard with some bushes and trees, lying at an intersection of two streets to the south and east. Birds tweet in the sunlight.

Sharp pain shoots up from your left hand.

* * *

>s
Study
A desk is shoved up against a wall, covered in papers.

Your suit lies crumpled in a corner.

>get all
(your suit)
You scurry into you rust-brown tweed suit like a frightened rat, quickly tying a Windsor knot from muscle memory.

>n
Kitchen
Pots and pans lie strewn across the floor.  Everything is upended. Your bedroom is to the west, your study lies to the south and the front door leads southwest.

Helicopter noises thunder overhead as searchlights glare in through the kitchen window.

>sw
(first opening the front door)

Upper Corridor
Dark walls rising over wood flooring creates this corridor. There are doors east and west and a stairwell snakes down to the ground floor to the north.

Klezmer music streams out from one of the doors to the west.

>n
Lobby
A front desk sits by the door leading out south-ways to the yard while a stairway to the north circles up into darkness. A wooden door stands in the north-eastern corner.

>ne
(first opening the wooden door)
It seems to be locked.

>n
Upper Corridor
Dark walls rising over wood flooring creates this corridor. There are doors east and west and a stairwell snakes down to the ground floor to the north.

Klezmer music streams out from one of the doors to the west.

>listen to the music
The shadows darken and lean in towards you.

Ghetto
Large shadows move about all around you. Beyond them, enormous shapes covered in yellow lights reach up to an unseen sky.

* * *

>sw
(first opening the front door)

Upper Corridor
Dark walls rising over wood flooring creates this corridor. There are doors east and west and a stairwell snakes down to the ground floor to the north.

Klezmer music streams out from one of the doors to the west.

>d
Lobby
A front desk sits by the door leading out south-ways to the yard while a stairway to the north circles up into darkness. A wooden door stands in the north-eastern corner.

>ne
(first opening the wooden door)
It seems to be locked.

>u
Upper Corridor
Dark walls rising over wood flooring creates this corridor. There are doors east and west and a stairwell snakes down to the ground floor to the north.

Klezmer music streams out from one of the doors to the west.

>eat music
The shadows darken and lean in towards you.

>look
Ghetto
Large shadows move about all around you. Beyond them, enormous shapes covered in yellow lights reach up to an unseen sky.

>e
You can't go that way.

* * *

>s
Study
A desk is shoved up against a wall, covered in papers.

Your suit lies crumpled in a corner.

>examine suit
Your trusty tweed suit. Somewhat unwashed but still presentable.

>examine myself
You are naked!

>get suit
You scurry into you rust-brown tweed suit like a frightened rat, quickly tying a Windsor knot from muscle memory.

* * *

>n
Kitchen
Pots and pans lie strewn across the floor.  Everything is upended. Your bedroom is to the west, your study lies to the south and the front door leads southwest.

Helicopter noises thunder overhead as searchlights glare in through the kitchen window.

>sw
(first opening the front door)

Upper Corridor
Dark walls rising over wood flooring forms this corridor. There are doors east and west and a stairwell snakes down to the ground floor to the north.

Klezmer music streams out from one of the doors to the west.

* * *

>e
(first opening the wooden grate)
The rotting wood finally gives way, creating an opening for escape!

Symmetric Alley
A long alley, or road, flanked by perfectly symmetrical houses down to the seaside docks. Behind you is a gray brick wall.

A wooden grate is affixed into the wall.

A bright light descends between the houses with a great roar - you yell out in fear as you realize the gun-ship has you cornered!

Sharp pain shoots up from your left hand.

>examine gunship
You can't see any such thing.

>look
Storage Closet
A naked light-bulb illuminates some shelving containing cleaning supplies and other, less identifiable things. The door to the west has been torn open, the wood in the frame splintered.

Sharp pain shoots up from your left hand.

* * *

>e
You crawl on all fours, slinking through the doorway away from the horrible light.

Kitchen
Pots and pans lie strewn across the floor.  Everything is upended. Your bedroom is to the west, your study lies to the south and the front door leads southwest.

Helicopter noises thunder overhead as searchlights glare in through the kitchen window.

>se
You can't go that way.

Helicopter noises thunder overhead as searchlights glare in through the kitchen window.

>s
Study
A desk is shoved up against a wall, covered in papers.

Your suit lies crumpled in a corner.

* * *

>n
Kitchen
Pots and pans lie strewn across the floor.  Everything is upended. Your bedroom is to the west, your study lies to the south and the front door leads southwest.

Helicopter noises thunder overhead as searchlights glare in through the kitchen window.

>sw
(first opening the front door)

Upper Corridor
Dark walls rising over wood flooring creates this corridor. There are doors east and west and a stairwell snakes down to the ground floor.

Klezmer music streams out from one of the doors to the west.

>take music
fixme

* * *

>e
You crawl on all fours, slinking through the doorway away from the horrible light.

Kitchen
Pots and pans lie strewn across the floor.  Everything is upended. Your bedroom is to the west, your study lies to the south and the front door leads southwest.

Helicopter noises thunder overhead as searchlights glare in through the kitchen window.

>examine window
In the street outside the death-squads are fighting back the rabble as the gun-ships fly overhead providing fire support. There seems to be many losses on both sides.

Helicopter noises thunder overhead as searchlights glare in through the kitchen window.

>s
Study
A desk is shoved up against a wall, covered in papers.

Your suit lies crumpled in a corner.

* * *

>sw
(first opening the front door)

Upper Corridor
Dark walls rising over wood flooring forms this corridor. There are doors east and west and a stairwell snakes down to the ground floor to the north.

Klezmer music streams out from one of the doors to the west.

>d
Lobby
A front desk sits by the door leading out south-ways to the yard while a stairway to the north circles up into darkness. A wooden door stands in the north-eastern corner.

>s
Front Yard
A small, paved yard with some bushes and trees, lying at an intersection of two streets to the south and east. Birds tweet in the sunlight.

>e
You can't go that way.

>n
Lobby
A front desk sits by the door leading out south-ways to the yard while a stairway to the north circles up into darkness. A wooden door stands in the north-eastern corner.

* * *

>e
Kitchen
Pots and pans lie strewn across the floor.  Everything is upended. Your bedroom is to the west, your study lies to the south and the front door leads southwest.

>examine window
A few cars stand parked on the street outside as people walk past.

>w
Never!

>sw
Upper Corridor
Dark walls rising over wood flooring forms this corridor. There are doors east and west and a stairwell snakes down to the ground floor to the north.

Klezmer music streams out from one of the doors to the west.

>listen to the music
The shadows darken and lean in towards you.

* * *

>examine men
The black-robed men in hats are conducting commerce in a language you don't quite recognize but parts of it sounds German and west-Slavic.

A donkey cart full of naked, emaciated corpses arrive by the rim of the pit. As the cart tilts backward they fall first en masse, then one by one into the deep gulf.

The great bell of the Palace rings out into the night.

>d
You take a few steps back and launch yourself into a running jump over the edge. You fall and fall and fall for what seems like several minutes.

A human skull catches your shoulder hard and the rest of your body slams into the top of a mountain of corpses. Down and down and down you tumble, coming to rest against the wall of the pit.

Charnel Pit
You are up against the edge of the pit, a barely curving wall of slimy gray brickwork. A morass of bones and rotting flesh crunch underfoot - enormous piles of corpses loom over you from all sides that is not the wall.

A wooden grate is affixed into the wall.

>examine corpses
Corpse upon corpse upon corpse, of all genders and ages, every single one thin as a rail with graying skin stretched taut over bone.

>search corpses
You find nothing of interest.

>smell corpses
The part of your human nature that before now where in ignorance of your surroundings catch up to you and you retch as you empty your stomach upon the "ground".

>look
Charnel Pit
You are up against the edge of the pit, a barely curving wall of slimy gray brickwork. A morass of bones and rotting flesh crunch underfoot - enormous piles of corpses loom over you from all sides that is not the wall.

A wooden grate is affixed into the wall.

* * *

>look
Storage Closet
A naked light-bulb illuminates some shelving containing cleaning supplies and other, less identifiable things. The door to the west has been torn open, the wood in the frame splintered.

Sharp pain shoots up from your left hand.

>w
Lobby
A front desk sits by the door leading out south-ways to the yard while a stairway to the north circles up into darkness. A wooden door has been torn open in the north-eastern corner.

A puddle of vomit has spread on the floor.

Sharp pain shoots up from your left hand.

You hear a woman sobbing from the door to the east, behind the counter.

>examine vomit
Disgusting. There's a sour taste in your mouth.

Sharp pain shoots up from your left hand.

You hear a woman sobbing from the door to the east, behind the counter.

>e
You knock on the door. The sobbing temporarily turns into frightened yelps and screams.

Sharp pain shoots up from your left hand.

You hear a woman sobbing from the door to the east, behind the counter.

>s
Front Yard
A small, paved yard with some bushes and trees, lying at an intersection of two streets to the south and east. Birds tweet in the sunlight.

Sharp pain shoots up from your left hand.

>eat pain
You can't see any such thing.

* * *

You are yanked from your slumber with a howl, cold sweat streaming down your naked body. Disentangling yourself from your sheets, your head turns immediately towards the window, flinching away from the vision.

Experiment A
An Interactive Fiction by whiteline
Release 1 / Serial number 180503 / Inform 7 build 6M62 (I6/v6.33 lib 6/12N) SD

Bedroom
The baleful star stares in through your bedroom window. Your bed is a mess of tangled, sweaty sheets. The kitchen lies immediately to the east.

>w
You can't go that way.

>e
You crawl on all fours, slinking through the doorway away from the horrible light.

Kitchen
Pots and pans lie strewn across the floor.  Everything is in a mess.

>eat
(the kitchenware)
That's plainly inedible.

* * *

You are yanked from your slumber with a howl, cold sweat streaming down your naked body. Disentangling yourself from your sheets, your head turns immediately towards the window, flinching away from the vision.

Experiment A
An Interactive Fiction by whiteline
Release 1 / Serial number 180503 / Inform 7 build 6M62 (I6/v6.33 lib 6/12N) SD

Bedroom
The baleful star stares in through your bedroom window. Your bed is a mess of tangled, sweaty sheets. The kitchen lies immediately to the east.

>examine me
You are naked!

>e
You crawl on all fours, slinking through the doorway away from the horrible light.

Kitchen
Pots and pans lie strewn across the floor.  Everything is upended. Your bedroom is to the west, your study lies to the south and the front door leads southwest.

Helicopter noises thunder overhead as searchlights glare in through the kitchen window.

* * *

>s
Study
A desk is shoved up against a wall, covered in papers.

Your suit lies crumpled in a corner.

>examine suit
You see nothing special about your suit.

>get suit
You scurry into you rust-brown tweed suit like a frightened rat, quickly tying a Windsor knot from muscle memory.

That isn't available.

* * *

>get suit
You scurry into you rust-brown tweed suit like a frightened rat, quickly tying a Windsor knot from muscle memory.

>examine me
You are wearing your tweed suit. You brush off a few specks of dust from your arm.

>n
Kitchen
Pots and pans lie strewn across the floor.  Everything is upended. Your bedroom is to the west, your study lies to the south and the front door leads southwest.

Helicopter noises thunder overhead as searchlights glare in through the kitchen window.

* * *

>sw
(first opening the front door)

Upper Corridor
Dark walls rising over wood flooring forms this corridor. There are doors east and west and a stairwell snakes down to the ground floor to the north.

Klezmer music streams out from one of the doors to the west.

>d
You walk down the stairs and enter the lobby.

Lobby
A front desk sits by the door leading out south-ways to the yard while a stairway to the north circles up into darkness. A wooden door stands in the north-eastern corner.

>s
Front Yard
A small, paved yard with some bushes and trees, lying at an intersection of two streets to the south and east. Birds tweet in the sunlight.

* * *

>n
Lobby
A front desk sits by the door leading out south-ways to the yard while a stairway to the north circles up into darkness. A wooden door stands in the north-eastern corner.

>u
You walk up the stairs and wind up in the corridor.

Upper Corridor
Dark walls rising over wood flooring forms this corridor. There are doors east and west and a stairwell snakes down to the ground floor to the north.

Klezmer music streams out from one of the doors to the west.

>e
Kitchen
Pots and pans lie strewn across the floor.  Everything is upended. Your bedroom is to the west, your study lies to the south and the front door leads southwest.

* * *

>examine pit
The pit is encircled with the finest masonry this side of the Alps. It seems to eat all light that falls into it, so as to give an impression of a perfectly tranquil artificial lake in the night.

>d
You take a few steps back and launch yourself into a running jump over the edge. You fall and fall and fall for what seems like several minutes.

A human skull catches your shoulder hard and the rest of your body slams into the top of a mountain of corpses. Down and down and down you tumble, coming to rest against the wall of the pit.

Charnel Pit
You are up against the edge of the pit, a barely curving wall of slimy gray brickwork. A morass of bones and rotting flesh crunch underfoot - enormous piles of corpses loom over you from all sides that is not the wall.

A wooden grate is affixed into the wall.

* * *

You are yanked from your slumber with a howl, cold sweat streaming down your naked body. Disentangling yourself from your sheets, your head turns immediately towards the window, flinching away from the vision.

Experiment A
An Interactive Fiction by whiteline
Release 1 / Serial number 180503 / Inform 7 build 6M62 (I6/v6.33 lib 6/12N) SD

Bedroom
The baleful star stares in through your bedroom window. Your bed is a mess of tangled, sweaty sheets. The kitchen lies immediately to the east.

>look star
Your mind wrenches your body away from the sight as trembles spread through your limbs.

>e
You crawl on all fours, slinking through the doorway away from the horrible light.

Kitchen
Pots and pans lie strewn across the floor.  Everything is upended. Your bedroom is to the west, your study lies to the south and the front door leads southwest.

Helicopter noises thunder overhead as searchlights glare in through the kitchen window.

* * *

>sw
(first opening the front door)

Upper Corridor
Dark walls rising over wood flooring creates this corridor. There are doors east and west and a stairwell snakes down to the ground floor to the north.

Klezmer music streams out from one of the doors to the west.

>w
You can't go that way.

>knock door
That's not a verb I recognise.

* * *

>u
Upper Corridor
Dark walls rising over wood flooring creates this corridor. There are doors east and west and a stairwell snakes down to the ground floor to the north.

Klezmer music streams out from one of the doors to the west.

>listen to the music
The shadows darken and lean in towards you.

* * *

>look
Ghetto
Large shadows move about all around you. Beyond them, enormous shapes covered in yellow lights reach up to an unseen sky.

>n
You can't go that way.

>e
You can't go that way.

>w
You can't go that way.

* * *

>sw
(first opening the front door)

Upper Corridor
Dark walls rising over wood flooring forms this corridor. There are doors east and west and a stairwell snakes down to the ground floor to the north.

Klezmer music streams out from one of the doors to the west.

>w
You bang and holler on the door but no-one opens.

>open door
Which do you mean, the front door or your neighbors door?

>open your neighbors door
You can't see any such thing.

>w
You bang and holler on the door but no-one opens.

>n
Lobby
A front desk sits by the door leading out south-ways to the yard while a stairway to the north circles up into darkness. A wooden door stands in the north-eastern corner.

* * *

>e
You can't go that way.

>ne
You can't go that way.

>s
You can't go that way.

>n
Lobby
A front desk sits by the door leading out south-ways to the yard while a stairway to the north circles up into darkness. A wooden door stands in the north-eastern corner.

* * *

>u
Upper Corridor
Dark walls rising over wood flooring forms this corridor. There are doors east and west and a stairwell snakes down to the ground floor to the north.

Klezmer music streams out from one of the doors to the west.

>listen music
I only understood you as far as wanting to listen.

* * *

>look star
Your mind wrenches your body away from the sight as trembles spread through your limbs.

>look bed
The blanket and bed-sheet is all bunched up.

>e
You crawl on all fours, slinking through the doorway away from the horrible light.

Kitchen
Your kitchenware lies strewn across the floor.  Everything is upended. Your bedroom is to the west, your small study lies to the south and the front door leads southwest.

Helicopter noises thunder overhead as searchlights glare in through the kitchen window.

>examine kitchenware
They are covered in dirt and grime.

Helicopter noises thunder overhead as searchlights glare in through the kitchen window.

>get kitchenware
Your shaking hands lack the strength to lift them at the moment.

Helicopter noises thunder overhead as searchlights glare in through the kitchen window.

>examine window
In the street outside the death-squads are fighting back the rabble as the gun-ships fly overhead providing fire support. There seems to be many losses on both sides.

Helicopter noises thunder overhead as searchlights glare in through the kitchen window.

* * *

You are yanked from your slumber with a howl, cold sweat streaming down your naked body. Disentangling yourself from your sheets, your head turns immediately towards the window, flinching away from the vision.

Experiment A
An Interactive Fiction by whiteline
Release 1 / Serial number 180503 / Inform 7 build 6M62 (I6/v6.33 lib 6/12N) SD

Bedroom
The baleful star stares in through your bedroom window. Your bed is a mess of tangled, sweaty sheets. The kitchen lies immediately to the east.

>knock on myself
Nothing happens.

>se
You can't go that way.

>s
You can't go that way.

>e
You crawl on all fours, slinking through the doorway away from the horrible light.

Kitchen
Pots and pans lie strewn across the floor.  Everything is in a mess. Your bedroom is to the west, your study lies to the south and the front door leads southwest.

Helicopter noises thunder overhead as searchlights glare in through the kitchen window.

>se
You can't go that way.

Helicopter noises thunder overhead as searchlights glare in through the kitchen window.

* * *

>sw
(first opening the front door)

Upper Corridor
Dark walls rising over wood flooring defines this corridor. There are doors east and west and a stairwell leads down to the ground floor.

Klezmer music streams out from one of the doors to the west.

>knock on the door
Which do you mean, the front door or your neighbors door?

>knock on your neighbors door
You can't see any such thing.

>knock on your neighbors door
You can't see any such thing.

* * *

You are yanked from your slumber with a howl, cold sweat streaming down your naked body. Disentangling yourself from your sheets, your head turns immediately towards the window, flinching away from the vision.

Experiment A
An Interactive Fiction by whiteline
Release 1 / Serial number 180503 / Inform 7 build 6M62 (I6/v6.33 lib 6/12N) SD

Bedroom
The baleful star stares in through your bedroom window. Your bed is a mess of tangled, sweaty sheets. The kitchen lies immediately to the east.

>se
You can't go that way.

>e
You crawl on all fours, slinking through the doorway away from the horrible light.

Kitchen
Pots and pans lie strewn across the floor.  Everything is upended. Your bedroom is to the west, your study lies to the south and the front door leads southwest.

Helicopter noises thunder overhead as searchlights glare in through the kitchen window.

* * *

>w
You can't go that way.

>knock west
(your neighbors door)
Nothing happens.

>knock w
Nothing happens.

>w
You can't go that way.

* * *

>sw
(first opening the front door)

Upper Corridor
Dark walls rising over wood flooring creates this corridor. There are doors east and west and a stairwell snakes down to the ground floor to the north.

Klezmer music streams out from one of the doors to the west.

>listen to the music
The shadows darken and lean in towards you.

* * *

>n
You attempt to push through the shadows on your sides but brusquely get jolted back. After a few attempts you manage to slip through.

Warsaw Grand Square
Here lies the great corpse-pit, a vast gulf of darkness fifty meters across encircled by the pavement of the Grand Square. Men in long black coats stand haggling in booths and by carts all around. The clock of the Palace reads midnight.

>s
You can't go that way.

>d
You can't go that way.

* * *

>n
You attempt to push through the shadows on your sides but brusquely get jolted back. After a few attempts you manage to slip through.

Warsaw Grand Square
Here lies the great corpse-pit, a vast gulf of darkness fifty meters across encircled by the pavement of the Grand Square. Men in long black coats stand haggling in booths and by carts all around. The clock of the Palace reads midnight.

>look coat
You can't see any such thing.

>look pit
You can't see any such thing.

>look
Warsaw Grand Square
Here lies the great corpse-pit, a vast gulf of darkness fifty meters across encircled by the pavement of the Grand Square. Men in long black coats stand haggling in booths and by carts all around. The clock of the Palace reads midnight.

>look
Warsaw Grand Square
Here lies the great corpse-pit, a vast gulf of darkness fifty meters across encircled by the pavement of the Grand Square. Men in long black coats stand haggling in booths and by carts all around. The clock of the Palace reads midnight.

A donkey cart full of emaciated, naked corpses arrive by the rim of the pit. As the cart tilts backward they fall first en masse, then one by one into the deep gulf.
The great bell of the Palace rings out into the night.

* * *

You are yanked from your slumber with a howl, cold sweat streaming down your naked body. Disentangling yourself from your sheets, your head turns immediately towards the window, flinching away from the vision.

Experiment A
An Interactive Fiction by whiteline
Release 1 / Serial number 180503 / Inform 7 build 6M62 (I6/v6.33 lib 6/12N) SD

Bedroom
The baleful star stares in through your bedroom window. Your bed is a mess of tangled, sweaty sheets. The kitchen lies immediately to the east.

>eat yourself
You can't see any such thing.

>eat me
You're plainly inedible.

>touch me
You achieve nothing by this.

* * *

You are yanked from your slumber with a howl, cold sweat streaming down your naked body. Disentangling yourself from your sheets, your head turns immediately towards the window, flinching away from the vision.

Experiment A
An Interactive Fiction by whiteline
Release 1 / Serial number 180503 / Inform 7 build 6M62 (I6/v6.33 lib 6/12N) SD

Bedroom
The baleful star stares in through your bedroom window. Your bed is a mess of tangled, sweaty sheets. The kitchen lies immediately to the east.

>examine star
You dare not look upon it!

>e
You crawl on all fours, slinking through the doorway away from the horrible light.

Kitchen
Pots and pans lie strewn across the floor.  Everything is upended. Your bedroom is to the west, your study lies to the south and the front door leads southwest.

Helicopter noises thunder overhead as searchlights glare in through the kitchen window.

* * *

>s
Study
A desk is shoved up against a wall, covered in papers.

Your suit lies crumpled in a corner.

>examine desk
A simple desk. Papers cover the surface.

* * *

>examine papers
It's your designs.

>get suit
You scurry into you rust-brown tweed suit like a frightened rat, quickly tying a Windsor knot from muscle memory.

* * *

>sw
(first opening the front door)

Upper Corridor
Dark walls rising over wood flooring creates this corridor. There are doors east and west and a stairwell snakes down to the ground floor to the north.

Klezmer music streams out from one of the doors to the west.

>read music
The shadows darken and lean in towards you.

>look
Ghetto
Large shadows move about all around you. Beyond them, enormous shapes covered in yellow lights reach up to an unseen sky.

>look at me
You can't quite make it out.

>e
You attempt to push through the shadows on your sides but brusquely get jolted back. After a few attempts you manage to slip through.

Warsaw Grand Square
Here lies the great corpse-pit, a vast gulf of darkness fifty meters across encircled by the pavement of the Grand Square. Men in long black coats stand haggling in booths and by carts all around. The clock of the Palace reads midnight.

>examine palace
The great stained-glass windows of the Palace of Trade glimmers in the electric-lights that also illuminates its great clock.

A donkey cart full of emaciated, naked corpses arrive by the rim of the pit. As the cart tilts backward they fall first en masse, then one by one into the deep gulf.
The great bell of the Palace rings out into the night.

* * *

You are yanked from your slumber with a howl, cold sweat streaming down your naked body. Disentangling yourself from your sheets, your head turns immediately towards the window, flinching away from the vision.

Experiment A
An Interactive Fiction by whiteline
Release 1 / Serial number 180503 / Inform 7 build 6M62 (I6/v6.33 lib 6/12N) SD

Bedroom
The baleful star stares in through your bedroom window. Your bed is a mess of tangled, sweaty sheets. The kitchen lies immediately to the east.

>enter grate
You can't see any such thing.

>s
You can't go that way.

>se
You can't go that way.

* * *

>e
(first opening the wooden grate)
You desperately try to tear away one of the planks and the wet oak budges a little bit.

>e
(first opening the wooden grate)
The rotting wood finally gives way, creating an opening for escape!

symmetric houses
A long alley, or road, flanked by perfectly symmetrical houses down to the seaside docks.

A wooden grate is affixed into the wall.

>enter grate
Charnel Pit
You are up against the edge of the pit, a barely curving wall of slimy gray brickwork. A morass of bones and rotting flesh crunch underfoot - enormous piles of corpses loom over you from all sides that is not the wall.

A wooden grate is affixed into the wall.

>go grate
symmetric houses
A long alley, or road, flanked by perfectly symmetrical houses down to the seaside docks.

A wooden grate is affixed into the wall.

* * *

You are yanked from your slumber with a howl, cold sweat streaming down your naked body. Disentangling yourself from your sheets, your head turns immediately towards the window, flinching away from the vision.

Experiment A
An Interactive Fiction by whiteline
Release 1 / Serial number 180503 / Inform 7 build 6M62 (I6/v6.33 lib 6/12N) SD

Bedroom
The baleful star stares in through your bedroom window. Your bed is a mess of tangled, sweaty sheets. The kitchen lies immediately to the east.

>examine hand
You are naked!

>e
You crawl on all fours, slinking through the doorway away from the horrible light.

Kitchen
Pots and pans lie strewn across the floor.  Everything is upended. Your bedroom is to the west, your study lies to the south and the front door leads southwest.

Helicopter noises thunder overhead as searchlights glare in through the kitchen window.

* * *

>n
You attempt to push through the shadows on your sides but brusquely get jolted back. After a few attempts you manage to slip through.

Warsaw Grand Square
Here lies the great corpse-pit, a vast gulf of darkness fifty meters across encircled by the pavement of the Grand Square. Men in long black coats stand haggling in booths and by carts all around. The clock of the Palace reads midnight.

>look
Warsaw Grand Square
Here lies the great corpse-pit, a vast gulf of darkness fifty meters across encircled by the pavement of the Grand Square. Men in long black coats stand haggling in booths and by carts all around. The clock of the Palace reads midnight.

A donkey cart full of naked, emaciated corpses arrive by the rim of the pit. As the cart tilts backward they fall first en masse, then one by one into the deep gulf.

The great bell of the Palace rings out into the night.

>d
You take a few steps back and launch yourself into a running jump over the edge. You fall and fall and fall for what seems like several minutes.

A human skull catches your shoulder hard and the rest of your body slams into the top of a mountain of corpses. Down and down and down you tumble, coming to rest against the wall of the pit.

Charnel Pit
You are up against the edge of the pit, a barely curving wall of slimy gray brickwork. A morass of bones and rotting flesh crunch underfoot - enormous piles of corpses loom over you from all sides that is not the wall.

A wooden grate is affixed into the wall.

>u
The opening is just a small circle far, far above you.

>e
(first opening the wooden grate)
You desperately try to tear away one of the planks and the wet oak budges a little bit.

* * *

>look
Storage Closet
A naked light-bulb illuminates some shelving containing cleaning supplies and other, less identifiable things. The door to the west has been torn open, the wood in the frame splintered.

Sharp pain shoots up from your left hand.

>look hand
You are wearing your tweed suit. You brush off a few specks of dust from your arm.
 Your left hand has several large splinters in it and is slick with blood.

Sharp pain shoots up from your left hand.

>w
Lobby
A front desk sits by the door leading out south-ways to the yard while a stairway to the north circles up into darkness. A wooden door has been torn open in the north-eastern corner.

Sharp pain shoots up from your left hand.

* * *

You are yanked from your slumber with a howl, cold sweat streaming down your naked body. Disentangling yourself from your sheets, your head turns immediately towards the window, flinching away from the vision.

Experiment A
An Interactive Fiction by whiteline
Release 1 / Serial number 180503 / Inform 7 build 6M62 (I6/v6.33 lib 6/12N) SD

Bedroom
The baleful star stares in through your bedroom window. Your bed is a mess of tangled, sweaty sheets. The kitchen lies immediately to the east.

>d
You can't go that way.

>e
You crawl on all fours, slinking through the doorway away from the horrible light.

Kitchen
Pots and pans lie strewn across the floor.  Everything is upended. Your bedroom is to the west, your study lies to the south and the front door leads southwest.

Helicopter noises thunder overhead as searchlights glare in through the kitchen window.

* * *

>sw
(first opening the front door)

Upper Corridor
Dark walls rising over wood flooring forms this corridor. There are doors east and west and a stairwell snakes down to the ground floor to the north.

Klezmer music streams out from one of the doors to the west.

>n
Lobby
A front desk sits by the door leading out south-ways to the yard while a stairway to the north circles up into darkness. A wooden door stands in the north-eastern corner.

>e
You can't go that way.

>open office
You have no business there.

* * *

You are yanked from your slumber with a howl, cold sweat streaming down your naked body. Disentangling yourself from your sheets, your head turns immediately towards the window, flinching away from the vision.

Experiment A
An Interactive Fiction by whiteline
Release 1 / Serial number 180503 / Inform 7 build 6M62 (I6/v6.33 lib 6/12N) SD

Bedroom
The baleful star stares in through your bedroom window. Your bed is a mess of tangled, sweaty sheets. The kitchen lies immediately to the east.

>examine bed
The blanket and bed-sheet is all bunched up.

>examine kitchen
You can't see any such thing.

>examine star
You dare not look upon it!

* * *

>e
You crawl on all fours, slinking through the doorway away from the horrible light.

Kitchen
Pots and pans lie strewn across the floor.  Everything is upended. Your bedroom is to the west, your study lies to the south and the front door leads southwest.

Helicopter noises thunder overhead as searchlights glare in through the kitchen window.

>examine pots
They are covered in dirt and grime.

Helicopter noises thunder overhead as searchlights glare in through the kitchen window.

>get pots
Your shaking hands lack the strength to lift them at the moment.

Helicopter noises thunder overhead as searchlights glare in through the kitchen window.

>examine window
In the street outside the death-squads are fighting back the rabble as the gun-ships fly overhead providing fire support. There seems to be many losses on both sides.

Helicopter noises thunder overhead as searchlights glare in through the kitchen window.

* * *

>examine papers
It's your designs.

>get papers
That's hardly portable.

>get suit
You scurry into you rust-brown tweed suit like a frightened rat, quickly tying a Windsor knot from muscle memory.

* * *

>examine music
The shadows darken and lean in towards you.

>look door
You can't see any such thing.

>look
Ghetto
Large shadows move about all around you. Beyond them, enormous shapes covered in yellow lights reach up to an unseen sky.

>examine shadows
You can't quite make it out.

>n
You attempt to push through the shadows on your sides but brusquely get jolted back. After a few attempts you manage to slip through.

Warsaw Grand Square
Here lies the great corpse-pit, a vast gulf of darkness fifty meters across encircled by the pavement of the Grand Square. Men in long black coats stand haggling in booths and by carts all around. The clock of the Palace reads midnight.

* * *

>examine pit
The pit is encircled with the finest masonry this side of the Alps. It seems to eat all light that falls into it, so as to give an impression of a perfectly tranquil artificial lake in the night.

>examine men
The black-robed men in hats are conducting commerce in a language you don't quite recognize but parts of it sounds German and west-Slavic.

>enter pit
That's not something you can enter.

>d
You take a few steps back and launch yourself into a running jump over the edge. You fall and fall and fall for what seems like several minutes.

A human skull catches your shoulder hard and the rest of your body slams into the top of a mountain of corpses. Down and down and down you tumble, coming to rest against the wall of the pit.

Charnel Pit
You are up against the edge of the pit, a barely curving wall of slimy gray brickwork. A morass of bones and rotting flesh crunch underfoot - enormous piles of corpses loom over you from all sides that is not the wall.

A wooden grate is affixed into the wall.

* * *

>e
(first opening the wooden grate)
You desperately try to tear away one of the planks and the wet oak budges a little bit.

>open grate
The rotting wood finally gives way, creating an opening for escape!

* * *

>look
Charnel Pit
You are up against the edge of the pit, a barely curving wall of slimy gray brickwork. A morass of bones and rotting flesh crunch underfoot - enormous piles of corpses loom over you from all sides that is not the wall.

A wooden grate is affixed into the wall.

>e
Symmetric Alley
A long alley, or road, flanked by perfectly symmetrical houses down to the seaside docks. Behind you is a gray brick wall.

A wooden grate is affixed into the wall.

A bright light descends between the houses with a great roar - you yell out in fear as you realize the gun-ship has you cornered!

Sharp pain shoots up from your left hand.

>examine hand
You are wearing your tweed suit. You brush off a few specks of dust from your arm.
 Your left hand has several large splinters in it and is slick with blood.

Sharp pain shoots up from your left hand.

>look
Storage Closet
A naked light-bulb illuminates some shelving containing cleaning supplies and other, less identifiable things. The door to the west has been torn open, the wood in the frame splintered.

Sharp pain shoots up from your left hand.

>w
Lobby
A front desk sits by the door leading out south-ways to the yard while a stairway to the north circles up into darkness. A wooden door has been torn open in the north-eastern corner.

Sharp pain shoots up from your left hand.

You hear a woman sobbing from the door to the east, behind the counter.

>e
You knock on the door. The sobbing temporarily turns into frightened yelps and screams.

Sharp pain shoots up from your left hand.

You hear a woman sobbing from the door to the east, behind the counter.

>e
You knock on the door. The sobbing temporarily turns into frightened yelps and screams.

Sharp pain shoots up from your left hand.

You hear a woman sobbing from the door to the east, behind the counter.

* * *

>s
Front Yard
A small, paved yard with some bushes and trees, lying at an intersection of two streets to the south and east. Birds tweet in the sunlight.

Sharp pain shoots up from your left hand.

>examine hand
You are wearing your tweed suit. You brush off a few specks of dust from your arm.
 Your left hand has several large splinters in it and is slick with blood.

Sharp pain shoots up from your left hand.

* * *

>examine bed
The blanket and bed-sheet is all bunched up.

>e
You crawl on all fours, slinking through the doorway away from the horrible light.

Kitchen
Pots and pans lie strewn across the floor.  Everything is upended. Your bedroom is to the west, your study lies to the south and the front door leads southwest.

Helicopter noises thunder overhead as searchlights glare in through the kitchen window.

* * *

>s
Study
A desk is shoved up against a wall, covered in papers.

Your suit lies crumpled in a corner.

>n
Kitchen
Pots and pans lie strewn across the floor.  Everything is upended. Your bedroom is to the west, your study lies to the south and the front door leads southwest.

Helicopter noises thunder overhead as searchlights glare in through the kitchen window.

>sw
You are naked!

Helicopter noises thunder overhead as searchlights glare in through the kitchen window.

* * *

>look
Ghetto
Large shadows move about all around you. Beyond them, enormous shapes covered in yellow lights reach up to an unseen sky.

>look shadows
You can't quite make it out.

>n
You attempt to push through the shadows on your sides but brusquely get jolted back. After a few attempts you manage to slip through.

Warsaw Grand Square
Here lies the great corpse-pit, a vast gulf of darkness fifty meters across encircled by the pavement of the Grand Square. Men in long black coats stand haggling in booths and by carts all around. The clock of the Palace reads midnight.

* * *

You are yanked from your slumber with a howl, cold sweat streaming down your naked body. Disentangling yourself from your sheets, your head turns immediately towards the window, flinching away from the vision.

Experiment A
An Interactive Fiction by whiteline
Release 1 / Serial number 180503 / Inform 7 build 6M62 (I6/v6.33 lib 6/12N) SD

Bedroom
The baleful star stares in through your bedroom window. Your bed is a mess of tangled, sweaty sheets. The kitchen lies immediately to the east.

>s
You can't go that way.

>e
You crawl on all fours, slinking through the doorway away from the horrible light.

Kitchen
Pots and pans lie strewn across the floor.  Everything is upended. Your bedroom is to the west, your study lies to the south and the front door leads southwest.

Helicopter noises thunder overhead as searchlights glare in through the kitchen window.

* * *

>e
You attempt to push through the shadows on your sides but brusquely get jolted back. After a few attempts you manage to slip through.

Warsaw Grand Square
Here lies the great corpse-pit, a vast gulf of darkness fifty meters across encircled by the pavement of the Grand Square. Men in long black coats stand haggling in booths and by carts all around. The clock of the Palace reads midnight.

>examine pit
The pit is encircled with the finest masonry this side of the Alps. It seems to eat all light that falls into it, so as to give an impression of a perfectly tranquil artificial lake in the night.

A donkey cart full of naked, emaciated corpses arrive by the rim of the pit. As the cart tilts backward they fall first en masse, then one by one into the deep gulf.

The great bell of the Palace rings out into the night.

* * *

>examine corpses
Corpse upon corpse upon corpse, of all genders and ages, every single one thin as a rail with graying skin stretched taut over bone.

The part of your human nature that before now where in ignorance of your surroundings catch up to you and you retch as you empty your stomach upon the "ground".

>examine corpses
Corpse upon corpse upon corpse, of all genders and ages, every single one thin as a rail with graying skin stretched taut over bone.

You retch and heave but your stomach is empty.

>poke corpses
That's not a verb I recognise.

>use corpses
That's not a verb I recognise.

>talk corpses
That's not a verb I recognise.

>turn corpses
It is fixed in place.

>e
(first opening the wooden grate)
You desperately try to tear away one of the planks and the wet oak budges a little bit.

* * *

>look
Storage Closet
A naked light-bulb illuminates some shelving containing cleaning supplies and other, less identifiable things. The door to the west has been torn open, the wood in the frame splintered.

Sharp pain shoots up from your left hand.

>eat pain
You can't see any such thing.

>restart
Are you sure you want to restart?

* * *

>yes
You are yanked from your slumber with a howl, cold sweat streaming down your body!

a
An Interactive Fiction by whiteline
Release 1 / Serial number 180303 / Inform 7 build 6M62 (I6/v6.33 lib 6/12N) SD

Bedroom
The baleful star shines in through the window. Your bed is a mess. The kitchen lies to the east.

>examine bed
You can't see any such thing.